00 00 00 00 00 00 00 00 00 00 00 00 00
00 05 00 05 00 05 00 05 00 05 00 05 00
00 05 00 05 00 05 00 05 00 05 00 05 00
00 05 00 05 00 05 10 05 00 05 00 05 00
00 05 00 05 00 04 00 04 00 05 00 05 00
00 04 00 04 00 02 00 02 00 04 00 04 00
02 00 02 02 00 04 00 04 00 02 02 00 02
09 00 04 04 00 02 00 02 00 04 04 00 09
00 02 00 02 00 05 05 05 00 02 00 02 00
00 05 00 05 00 05 00 05 00 05 00 05 00
00 05 00 05 00 04 00 04 00 05 00 05 00
00 05 00 05 00 00 00 00 00 05 00 05 00
00 00 00 00 00 00 00 00 00 00 00 00 00
