00 00 00 00 00 00 00 00 00 00 00 00 00
00 01 04 05 00 00 00 00 00 00 05 04 03
01 04 00 00 05 00 12 12 00 05 00 00 01
05 00 00 00 05 12 12 12 12 05 00 00 01
05 00 00 01 05 12 10 10 12 05 03 00 05
01 02 02 05 11 11 11 11 11 11 05 05 05
00 05 05 05 10 10 05 10 10 05 05 05 03
00 00 05 05 10 00 05 00 10 05 05 03 00
00 00 05 05 05 05 05 05 05 05 05 03 00
05 12 04 04 04 10 10 04 04 04 04 12 05
05 12 12 12 12 12 12 12 12 12 12 12 05
00 00 12 12 12 00 00 00 12 12 12 12 00
00 00 00 03 00 00 00 00 00 00 03 00 00
