00 00 00 00 00 10 00 05 00 05 05 00 00
00 01 05 05 05 05 00 05 00 00 00 00 00
00 00 00 03 00 05 00 05 05 00 12 12 12
00 01 00 00 00 00 00 10 00 12 12 12 12
00 01 00 05 05 05 10 05 05 12 12 04 10
00 04 04 04 10 00 00 05 00 12 12 00 01
01 05 05 05 00 10 12 12 12 12 12 00 00
00 00 00 10 00 00 12 12 12 12 12 05 00
10 05 00 12 12 12 12 10 12 12 12 05 00
01 05 12 12 12 12 12 00 00 00 00 05 03
00 05 12 12 00 00 00 00 09 05 05 05 00
00 00 12 12 00 00 00 00 00 05 00 01 00
00 02 12 12 00 00 00 00 00 00 00 00 00
