00 00 00 00 00 00 00 05 05 05 00 00 00
00 05 05 05 02 00 02 00 00 05 00 00 00
00 00 00 00 05 00 04 00 00 00 00 05 05
00 11 11 11 11 11 00 05 03 00 00 05 09
00 00 07 07 07 11 00 05 00 10 08 05 00
05 00 05 05 05 11 11 11 00 11 05 05 00
00 00 00 00 10 11 00 00 00 11 09 00 00
11 11 11 00 11 11 05 05 00 11 00 00 00
00 00 00 00 00 05 09 09 00 11 11 11 00
05 05 05 00 00 00 00 00 00 00 00 00 00
00 00 05 00 09 09 00 00 00 05 05 00 01
05 00 00 00 00 00 00 00 00 05 00 00 05
00 00 00 00 00 00 00 00 00 00 00 00 00
