00 00 00 00 02 00 00 00 02 00 00 00 00
00 05 05 05 05 00 00 00 05 05 05 05 00
00 05 00 00 00 00 05 00 00 00 00 10 00
00 05 00 05 04 00 00 00 04 05 00 05 05
00 05 00 03 12 07 10 07 12 01 00 10 05
00 04 00 00 12 12 12 12 12 00 00 09 05
05 07 00 00 12 12 12 12 12 00 00 02 05
05 10 00 03 12 09 10 09 12 01 00 05 00
05 05 00 05 02 00 00 00 02 05 00 10 00
05 10 00 00 00 00 05 00 00 00 00 05 00
05 05 05 05 05 00 00 00 05 05 05 10 10
05 05 00 00 04 00 00 00 04 00 00 05 00
05 05 00 00 00 00 00 00 00 00 00 00 00
