00 00 00 00 00 00 00 00 00 00 00 00 00
12 12 00 00 02 05 05 05 02 00 00 12 12
12 00 00 01 05 05 05 05 05 03 00 00 12
00 00 00 05 05 12 05 12 05 05 00 00 00
00 00 00 05 12 12 05 12 12 05 00 00 00
12 00 00 05 05 05 05 05 05 05 00 00 12
12 12 00 00 05 12 05 12 05 00 00 12 12
11 11 11 00 05 05 05 05 05 00 11 11 11
00 00 00 00 01 01 01 01 01 00 00 00 00
00 00 00 00 03 03 03 03 03 00 00 00 00
06 06 06 00 00 00 00 00 00 00 08 08 08
03 03 03 00 00 00 00 00 00 00 01 01 01
08 08 08 06 00 00 00 00 00 08 06 06 06
