00 00 00 00 05 05 00 00 05 00 00 00 00
00 12 12 05 05 00 00 00 05 00 00 00 00
12 12 12 12 12 12 12 12 05 05 00 00 00
12 09 05 12 05 05 05 12 12 12 12 05 10
12 12 05 12 12 12 09 12 12 05 08 05 00
00 12 12 05 07 12 12 12 12 05 00 05 00
00 05 05 05 05 05 12 12 05 05 03 12 12
06 09 05 05 00 00 00 05 04 00 00 00 12
00 05 00 05 00 00 02 04 12 12 05 03 12
00 05 00 00 00 00 04 12 12 05 00 00 12
00 05 05 03 01 05 12 12 02 12 05 12 12
00 00 05 00 00 00 00 00 05 12 04 12 00
00 00 04 00 00 00 00 00 00 12 12 12 00
