00 00 00 00 00 00 00 00 00 00 00 00 00
00 00 10 12 10 00 00 00 00 00 00 00 00
00 00 00 12 00 12 07 00 00 00 00 00 00
00 12 00 00 00 00 12 02 00 00 00 00 00
00 12 12 00 00 12 00 12 07 00 00 00 00
00 12 00 12 00 12 00 00 12 02 00 00 00
00 12 00 00 12 00 00 00 12 12 07 00 00
00 00 12 00 00 00 00 12 12 12 12 02 00
00 00 00 12 00 00 12 00 12 12 12 12 00
05 00 00 00 00 00 12 00 00 12 12 12 10
05 05 00 00 00 00 00 12 00 12 12 12 12
10 05 05 00 00 00 00 00 12 00 12 12 12
10 10 05 05 00 00 00 00 12 00 00 12 12
