00 00 00 00 00 00 00 00 00 00 02 00 00
00 05 00 05 03 00 00 13 13 13 05 05 00
00 05 00 00 05 00 10 13 13 13 13 13 00
13 13 13 08 05 00 00 05 13 13 13 13 00
13 13 13 13 13 13 05 05 01 03 00 00 00
00 00 06 13 13 13 13 05 01 03 00 09 09
05 05 05 05 13 13 13 13 13 13 13 05 05
00 00 00 05 05 13 13 13 00 00 00 00 00
00 05 05 05 00 13 13 13 05 05 00 05 00
13 13 13 05 13 00 00 00 00 05 00 05 00
13 13 13 13 13 09 00 09 00 00 02 05 00
05 13 13 13 13 00 00 00 00 05 00 00 00
05 05 08 00 00 00 00 00 00 05 00 05 00
