00 00 00 00 00 00 00 00 10 10 10 12 00
00 05 00 00 00 00 00 00 10 00 00 10 00
05 12 05 00 00 00 05 05 05 05 00 10 00
00 05 12 05 00 00 05 00 12 05 10 10 00
00 00 05 00 12 10 05 12 00 05 00 00 00
00 00 00 00 10 00 05 10 05 05 00 00 00
00 00 05 05 10 05 00 10 00 00 00 00 00
00 00 05 00 12 05 10 12 00 00 00 00 00
10 10 10 12 00 05 00 00 05 05 00 00 00
10 00 05 05 05 05 00 00 05 10 10 00 00
10 00 00 10 00 00 00 00 00 10 05 05 00
12 10 10 10 00 00 00 00 00 00 05 10 10
00 00 00 00 00 00 00 00 00 00 00 10 10
