00 05 00 05 00 05 00 05 00 05 00 05 00
00 05 00 05 00 05 00 05 00 05 00 05 00
00 09 00 09 00 09 00 09 00 09 00 09 00
02 00 02 00 05 00 00 00 05 00 02 00 02
05 00 05 04 05 00 05 00 05 04 05 00 05
09 00 09 00 10 00 09 00 10 00 09 00 09
12 12 00 00 05 00 12 00 05 00 00 12 12
12 12 12 12 05 04 12 04 05 12 12 12 12
12 12 12 12 12 12 12 12 12 12 12 12 12
02 00 02 00 05 12 12 12 05 00 02 00 02
00 05 00 05 00 00 12 00 00 05 00 05 00
00 05 00 05 00 00 00 00 00 05 00 05 00
00 04 00 04 00 00 00 00 00 04 00 04 00
