00 00 00 10 00 00 00 10 00 00 00 00 00
00 05 00 10 00 00 00 05 00 05 00 05 00
00 05 00 00 00 00 02 05 00 05 10 05 00
00 00 00 05 00 00 00 00 00 10 00 00 00
12 00 00 05 00 00 10 00 00 05 12 05 10
12 12 00 00 00 05 00 00 10 00 12 00 00
00 05 05 05 12 12 12 10 00 00 12 05 00
00 00 00 10 12 05 00 05 00 05 00 05 00
10 05 00 10 00 05 00 05 00 00 00 05 00
00 05 00 05 00 05 05 05 00 05 00 05 00
00 05 00 05 00 04 04 04 00 00 00 00 00
00 05 00 00 00 00 00 00 00 05 00 05 00
00 05 00 05 00 00 00 00 00 05 05 05 00
