00 00 00 11 00 05 00 00 05 00 05 00 00
00 00 00 00 00 00 00 00 05 00 10 00 00
00 00 00 11 00 02 10 00 05 00 05 00 00
09 00 05 11 00 10 00 02 04 00 05 00 00
00 00 05 11 00 00 00 05 00 00 00 00 00
05 00 05 11 11 00 11 11 11 11 00 00 05
00 00 00 02 00 00 00 12 00 11 00 09 09
05 05 01 05 00 10 12 12 12 11 00 02 02
04 00 01 00 00 05 12 12 12 11 00 05 00
00 07 00 00 00 05 00 12 00 11 00 12 00
00 05 00 07 00 04 04 04 00 00 12 12 12
00 05 00 05 00 00 00 00 00 11 12 12 12
00 00 00 00 00 00 00 00 00 11 00 12 00
