00 00 00 02 02 02 00 00 02 00 00 00 00
00 02 05 05 05 05 05 05 05 05 00 00 00
00 12 12 12 12 12 12 12 12 05 05 00 00
12 12 00 00 00 00 00 00 12 12 05 05 00
12 00 10 00 00 10 00 00 00 12 12 12 00
12 00 10 00 00 10 00 00 00 12 12 12 00
12 00 00 12 00 00 00 00 12 12 05 05 03
12 12 12 12 12 12 12 12 12 05 05 05 03
05 12 12 05 05 12 12 12 05 05 05 05 00
00 05 05 05 05 05 05 05 05 05 05 00 10
10 00 05 10 05 05 05 05 05 05 03 00 10
00 10 05 04 10 00 00 00 05 05 10 10 10
00 00 00 00 00 00 00 00 00 00 00 00 00
