00 00 00 00 00 12 00 00 00 00 00 00 00
00 00 00 00 12 10 12 00 00 00 00 00 00
00 00 12 00 00 12 00 00 12 12 00 00 00
00 12 05 12 00 00 00 12 05 05 12 00 00
00 00 12 05 12 00 00 00 12 12 00 00 12
12 00 00 12 00 00 12 00 00 00 00 12 10
05 12 00 00 00 12 10 12 00 00 12 00 12
10 05 12 00 00 00 12 00 00 12 10 12 00
05 12 00 00 12 00 00 00 12 00 12 00 00
12 00 00 12 05 12 00 12 05 12 00 00 00
00 00 00 12 05 12 00 00 12 00 00 12 00
00 12 00 00 12 00 00 00 00 00 12 10 12
12 10 12 00 00 00 00 00 00 12 05 12 00
