00 00 00 00 00 00 00 00 00 00 00 00 00
00 00 00 00 00 10 10 00 00 00 00 00 00
00 00 00 00 00 00 10 00 00 00 00 00 00
00 10 10 12 12 05 10 05 12 12 10 10 00
00 00 00 10 12 12 10 12 12 10 00 00 00
12 00 00 00 10 12 12 12 10 00 00 00 12
10 12 00 00 00 12 12 12 00 00 00 12 10
12 00 00 00 07 09 12 09 07 00 00 00 12
00 00 00 00 10 00 07 00 10 00 00 00 00
00 00 00 10 00 00 10 00 00 10 00 00 00
00 00 00 00 00 00 00 00 00 00 00 00 00
00 00 00 00 00 00 00 00 00 00 00 00 00
00 00 10 00 00 00 00 00 00 00 10 00 00
