00 00 10 00 05 09 00 00 00 00 01 00 00
00 00 05 00 05 12 00 04 05 05 05 00 00
00 12 12 00 05 12 01 03 00 00 00 10 10
12 12 12 12 12 12 05 05 05 00 01 05 00
00 00 12 12 02 02 09 05 00 01 05 04 01
05 09 00 02 04 04 00 00 00 05 04 00 01
01 00 02 05 13 13 13 13 13 13 13 13 13
01 00 04 00 13 13 13 13 13 13 13 13 13
00 00 10 00 13 13 13 13 13 13 13 13 13
05 00 05 00 13 13 13 13 13 13 13 13 13
01 00 05 00 13 13 13 13 13 13 13 13 13
01 00 05 00 00 00 00 00 13 13 13 13 13
00 00 04 00 00 00 00 00 00 13 13 13 13
