00 00 00 10 00 05 00 05 00 05 00 10 00
00 05 00 05 00 00 00 00 00 10 00 00 00
00 05 00 05 00 00 10 00 00 10 00 10 10
00 05 00 00 00 05 00 10 05 00 00 00 10
00 00 00 00 05 05 00 05 05 00 10 00 00
00 00 10 00 05 00 00 05 05 00 05 05 00
10 00 10 00 00 05 00 10 00 00 10 05 00
00 00 05 05 00 05 00 00 00 05 10 00 00
00 10 05 05 00 05 05 00 05 05 00 00 05
00 05 00 00 00 05 10 00 00 00 00 05 05
00 00 00 05 00 05 05 10 00 10 00 00 05
05 00 05 05 00 00 00 00 00 05 10 00 00
05 00 05 00 00 00 00 00 00 05 05 05 00
