00 00 11 11 00 00 00 00 00 00 00 00 00
07 00 00 11 12 00 03 00 00 00 00 00 00
12 07 00 00 00 00 08 00 03 00 11 11 00
12 12 00 09 02 01 00 00 08 12 11 00 00
12 12 12 00 00 10 02 01 00 00 00 00 07
12 12 09 07 00 01 00 10 02 00 00 07 12
12 09 00 00 04 10 00 01 00 09 00 12 12
00 00 00 00 00 03 04 10 00 00 12 12 12
00 00 11 12 06 00 00 03 04 07 09 12 12
00 11 11 00 01 00 06 00 00 00 00 00 12
00 00 00 00 00 00 01 00 12 11 00 00 09
10 00 00 00 00 00 00 00 00 11 11 00 00
10 10 00 00 00 00 00 00 00 00 00 00 10
