00 00 00 00 00 00 00 00 00 00 06 08 00
00 00 00 00 00 00 07 00 00 00 10 00 00
00 00 00 00 00 02 12 02 00 05 03 00 00
00 00 00 00 07 12 12 12 07 05 03 00 00
00 00 00 02 12 12 13 12 12 05 03 00 00
00 00 07 12 12 13 13 13 12 12 03 00 00
00 02 12 12 13 13 13 13 13 12 12 02 00
07 12 12 13 13 13 13 13 13 13 12 12 07
12 12 13 13 13 13 13 13 13 13 13 12 12
00 12 13 13 13 13 13 13 13 13 13 12 00
00 12 13 13 13 13 13 13 13 13 13 12 00
00 12 13 13 13 00 00 00 13 13 13 12 00
00 12 13 13 00 00 00 00 00 13 13 12 00
