00 00 00 00 05 00 00 00 05 00 00 00 00
00 12 12 12 05 00 00 00 00 00 07 07 07
05 12 12 12 00 00 00 00 00 00 00 00 00
12 12 12 12 00 00 00 05 00 05 05 05 03
12 12 12 12 05 05 05 04 00 05 00 01 00
12 12 12 12 00 00 05 00 00 00 00 01 00
00 12 00 00 00 00 10 10 10 00 00 12 00
00 02 00 02 00 00 00 00 00 12 12 12 12
05 03 01 05 03 01 04 04 04 12 12 12 12
00 00 00 00 00 05 00 02 02 12 12 12 12
05 00 00 08 00 00 00 00 00 12 12 12 00
05 05 00 08 00 00 00 00 00 12 12 12 00
10 05 05 00 00 00 00 00 00 05 00 00 00
