00 00 00 00 00 00 00 00 00 00 00 00 00
00 00 00 00 00 02 02 00 00 00 07 00 00
00 07 07 00 02 12 12 07 00 02 12 02 00
02 12 12 02 12 12 12 12 02 12 12 12 02
12 12 12 12 12 12 12 12 12 12 12 12 12
10 12 11 12 12 12 12 12 11 12 12 12 12
12 12 11 11 11 12 12 12 11 11 11 12 10
12 12 12 12 11 12 10 12 12 12 11 12 12
12 12 12 12 12 12 12 12 12 12 12 12 12
12 12 12 12 12 04 04 12 12 12 12 12 09
09 12 12 12 04 00 00 04 12 12 12 09 00
00 09 04 04 00 00 00 00 04 04 04 00 00
00 00 00 00 00 00 00 00 00 00 00 00 00
