00 00 00 11 00 00 00 00 11 00 00 00 00
11 11 00 11 00 11 11 11 11 00 11 11 11
12 12 05 00 00 05 00 00 11 00 11 12 11
12 11 11 11 11 00 10 00 00 05 12 12 12
12 12 00 11 00 00 11 00 11 11 11 11 12
11 11 00 11 00 11 11 00 00 11 00 00 00
00 00 05 12 05 00 05 12 00 11 00 00 11
00 11 11 12 11 11 11 11 00 12 05 00 11
05 00 00 05 00 00 11 00 12 12 11 00 11
11 11 00 11 11 00 11 05 11 11 11 00 00
00 00 05 00 12 12 00 00 12 11 00 00 11
00 11 11 11 12 00 00 00 00 11 00 11 11
00 11 00 00 00 00 00 00 00 00 00 00 00
