13 13 13 13 13 13 00 13 13 13 13 13 13
13 13 13 13 13 13 13 13 13 13 13 13 13
13 13 13 05 13 13 13 13 13 05 13 13 13
13 05 00 05 00 05 13 05 00 05 00 05 13
13 04 04 05 00 00 00 00 00 05 00 00 13
13 13 13 05 02 05 10 05 02 05 13 13 13
10 13 13 13 00 09 00 09 00 13 13 13 10
13 13 13 13 00 02 00 02 00 13 13 13 13
13 13 13 13 00 05 00 05 00 13 13 13 13
13 13 13 05 00 00 02 00 00 05 13 13 13
13 05 13 05 00 09 09 09 00 05 13 05 13
00 05 02 05 00 00 00 00 00 05 02 05 00
00 04 00 00 00 00 00 00 00 00 00 04 00
