00 00 00 00 10 00 00 00 00 10 00 00 00
00 10 00 00 00 10 00 00 10 12 12 00 00
00 00 10 00 00 00 00 10 12 07 08 00 00
00 00 00 10 00 12 12 12 12 12 00 06 00
00 08 00 00 10 12 12 10 12 00 00 10 00
00 09 08 12 00 10 12 12 10 00 00 06 00
00 00 12 12 12 12 12 00 00 10 00 00 00
00 07 08 12 00 10 12 00 00 00 10 00 00
00 12 12 12 10 00 10 00 07 00 00 10 00
12 12 12 10 00 00 00 00 06 00 00 00 00
00 00 10 00 00 00 00 00 00 00 00 06 10
00 00 00 00 00 00 00 00 00 07 08 00 00
08 00 07 00 00 00 00 00 00 00 00 00 00
