00 00 00 00 03 01 00 00 00 00 00 00 00
03 03 03 01 00 03 00 00 03 03 00 00 00
03 03 03 05 05 00 00 00 03 05 03 00 00
01 01 00 05 03 00 00 01 03 05 05 00 00
00 03 00 05 01 03 00 03 05 05 05 00 00
00 03 01 00 00 05 03 05 01 01 05 00 00
00 03 00 00 01 05 05 03 00 03 05 00 00
00 01 00 00 03 05 05 03 00 03 05 00 00
00 01 04 04 00 05 05 05 00 03 03 04 05
00 01 00 00 01 03 05 01 03 00 03 01 01
00 00 03 00 05 01 03 05 05 00 00 01 00
00 00 03 01 03 00 00 00 05 03 00 03 00
00 00 03 01 00 00 00 00 00 05 05 00 00
