00 12 12 00 00 00 00 00 00 00 00 12 00
12 12 00 00 02 05 05 02 02 00 00 00 12
12 00 00 01 05 05 05 05 05 05 02 00 09
09 00 00 05 05 05 05 05 05 05 05 03 00
00 00 01 04 00 00 00 04 05 05 00 03 00
11 00 01 00 08 00 08 00 05 03 00 00 00
00 00 05 00 02 02 00 00 05 03 00 11 11
00 00 05 05 05 05 05 05 05 05 00 00 00
00 01 05 05 05 05 05 05 05 05 03 00 00
00 04 04 05 05 05 05 05 05 04 04 00 00
00 05 05 02 04 05 05 04 02 05 05 00 12
12 00 04 04 00 00 00 00 04 04 00 12 12
10 12 00 00 00 00 00 00 00 00 12 12 10
