00 00 00 00 05 05 00 00 00 00 00 00 00
07 00 02 00 05 00 00 00 09 09 10 00 00
10 00 05 00 00 00 05 00 00 00 00 00 00
05 00 05 05 05 00 05 05 00 11 11 00 11
04 00 00 00 04 00 00 00 00 11 00 00 00
00 00 02 00 11 11 00 11 11 11 00 05 05
05 05 00 00 11 05 00 05 03 00 00 00 00
00 00 00 00 11 00 00 00 00 00 06 08 00
11 11 11 00 11 00 10 00 05 00 06 00 00
00 00 00 02 02 00 00 00 00 00 06 05 05
00 00 00 00 05 04 04 04 05 02 00 00 00
05 05 04 00 00 00 00 00 00 04 05 00 00
04 00 00 00 00 00 00 00 00 00 00 00 00
