00 00 00 00 00 01 00 03 12 12 00 00 00
00 03 06 00 03 00 00 00 01 12 03 01 12
00 03 06 00 03 00 05 00 01 12 03 01 12
00 05 00 00 05 00 10 00 05 12 00 05 12
00 00 00 01 09 00 05 00 04 08 00 12 12
05 05 03 00 00 12 05 12 00 00 01 05 05
00 00 00 00 01 12 12 12 03 00 00 00 00
10 05 05 00 04 12 12 12 04 01 05 05 10
09 09 09 00 02 00 12 00 02 00 09 09 09
00 05 00 00 05 00 00 00 05 00 00 00 00
00 05 03 00 00 04 00 04 00 00 01 05 12
00 00 04 00 00 00 00 00 00 00 12 12 12
00 00 02 00 00 00 00 00 00 00 02 12 12
