00 00 00 00 00 00 00 09 09 00 00 00 00
00 00 10 09 09 09 00 00 00 00 10 00 00
00 00 10 00 00 00 12 00 09 10 10 00 00
00 10 00 00 00 12 10 00 00 00 10 00 00
00 00 00 00 12 10 10 00 00 00 09 10 00
00 10 00 12 10 10 10 00 10 00 00 00 00
00 06 00 10 10 00 00 00 10 10 00 00 00
08 00 00 00 10 00 10 10 10 00 00 06 00
00 06 10 00 00 00 10 10 12 00 00 10 00
00 10 00 00 00 00 10 12 00 00 10 10 00
00 09 09 10 00 00 12 00 00 10 00 00 00
00 00 00 00 00 00 00 00 00 09 00 07 10
07 07 00 00 00 00 00 00 00 00 00 00 00
