00 00 05 00 00 05 00 02 00 05 00 00 00
12 05 05 05 00 05 00 07 00 05 03 00 00
12 12 12 00 00 04 00 05 00 04 00 01 03
12 11 11 11 11 11 11 11 11 11 11 00 11
00 05 00 00 00 00 02 02 00 00 00 00 00
00 00 05 00 00 01 05 05 04 05 04 09 09
05 05 00 05 00 01 05 05 12 05 07 07 05
00 00 00 10 00 07 00 12 12 12 12 00 00
11 11 00 11 11 11 11 11 00 11 11 11 11
12 12 00 01 00 00 02 02 00 00 00 00 00
12 12 05 00 03 00 00 01 00 07 02 05 00
12 07 05 00 03 00 00 00 00 04 00 05 00
00 00 00 00 00 00 00 00 00 02 00 04 00
