00 00 00 05 00 00 00 00 00 07 12 00 00
05 00 00 00 00 00 07 12 06 10 08 00 05
00 00 00 07 12 06 10 08 00 09 12 00 00
00 00 06 10 08 00 09 12 00 00 00 00 00
00 00 00 09 12 00 00 00 00 00 00 00 00
00 00 00 12 07 12 00 12 07 12 00 00 00
10 05 00 06 10 08 00 06 10 08 00 05 10
00 00 00 12 09 12 00 12 09 12 00 00 00
00 00 00 00 07 00 00 00 07 00 00 00 00
05 00 00 06 10 08 00 06 10 08 00 00 05
05 00 00 12 09 12 00 12 09 12 00 00 05
00 00 02 00 00 00 00 00 00 00 02 00 00
00 00 05 05 00 00 00 00 00 05 05 00 00
